[level1]
map =   ................................
        ................................
        ................................
        ................................
        ................................
        ................................
        ................................
        ........................p.......
        ....p.................p.........
        ................................
        ................................
        ................................
        ................................
        ................................
        ................................
        ................................
        ................................
        ................................
        ................................
        ................................
        ................................
        ................................
        .........p......................
        ................................
        ................................
        ................................
        ................................
        ................................
        ................................
        ................................
        ................................
        ................................
        ................................
        ................................
        ................................
        ................................
        ................................
        ................................
        ................................
        ................................
        ................................
        ................................
        ................................
        ................................
        ................................
        ................................
        ................................
        ................................
        ................................
        ................................
        ................................
        ................................
        ................................
        ................................
        ................................
        ................................
        ................................
        ................................
        ................................
        ................................
