[level1]
map =   ................................
        ................................
        ........p..........p............
        ................................
        ................................
        ................................
        ................................
        ........................p.......
        ....p.................p.........
        ................................
        ................................
        ........p.......................
        ................................
        ................................
        ................................
        ................................
        ................................
        ...............p..p............p
        ................................
        ................................
        ..............hhhh..............
        ..............hhhh..............
        ..............hhhh..............
        ..............hhhh..............
        ..............hhhh..............
        ..............hhhh..............
        ..............hhhh..............
        ..............hhhh..............
        ..............hhhh..............
        ................................
        ................................
        ................................
        ................................
        .....h..........................
        .....h..........h...............
        .....h..........h...............
        .....h................h.....h...
        .....h......................h...
        ................................
        ................................
        ................................
        ................................
        ................................
        ................................
        ................................
        ................................
        ................................
        ................................
        ................................
        ................................
        ................................
        ................................
        ................................
        ................................
        ................................
        ................................
        ................................
        ................................
        ................................
        ................................
