[level1]
map =   ................................
        ................................
        ................................
        ................................
        ................................
        ................................
        ................................
        ........................p.......
        ....p.................p.........
        ................................
        ................................
        ................................
        ................................
        ................................
        ................................
        ................................
        ................................
        ...............p................
        ................................
        ..............hhhh..............
        ..............hhhh..............
        ..............hhhh..............
        ..............hhhh..............
        ..............hhhh..............
        ..............hhhh..............
        ..............hhhh..............
        ..............hhhh..............
        ..............hhhh..............
        ..............hhhh..............
        ................................
        ................................
        ................................
        ................................
        ................................
        ................................
        ................................
        ................................
        ................................
        ................................
        ................................
        ................................
        ................................
        ................................
        ................................
        ................................
        ................................
        ................................
        ................................
        ................................
        ................................
        ................................
        ................................
        ................................
        ................................
        ................................
        ................................
        ................................
        ................................
        ................................
        ................................
